111111111111111111111111111
101001010010000010100100001
101001001010101000100100001
1P0000000C00C000000C0000001
1E00000000000C0C00000C00001
1C10010100100C0010100100001
101001001010101000100100001
101001001010101000100100001
101001001010101000100100001
101001001010101000100100001
101001001010101000100100001
101001001010101000100100001
101001001010101000100100001
101C0100101010100010C000001
1010010010101010C0100000001
10100C100101010100000010001
101001001010101001100100001
101001001010101000100100001
10000100C0101000C0110010001
1C10C00010101E1000100111001
111111111111111111111111111