111111111111111111111111111
101001010010000010100100001
101001001010101000100100001
1P0000000C00C000000C0000001
10E0000000000C0C00000C00001
1C10010100100C0010100100001
101001001C10101000100100001
101001001C10101000100100001
101001001C10101000100100001
101001001C10101C0010010C001
101001001010101000100100001
101001001010101000100100001
101001001010101000100100001
101C0100101010100010C000001
1010010010101010C0100000001
10100C100101010100000010001
101001001010101001100100001
10100100101010100010010C001
10000100C0001000C011001C001
1C10C0001010001000100111001
111111111111111111111111111