11111111111111
10100101001001
1P0000000C0001
1E000000000001
1010010a1010b1
11111111111111